# Any line followed by a '#' character is ignored
# Section headings must be in square brackets
# Subsections within a section should follow the format:
#   [filename within code directory][tab character \t][subsection title]

[Combinatorial optimization]
Dinic.cc	Sparse max-flow(aka Modified Ford Fulkerson)
MinCut.cc	Global min-cut

[Geometry]
ConvexHull.cc	Convex hull
Geometry.cc	Miscellaneous geometry

[Numerical algorithms]
FFT_new.cc	Fast Fourier transform
sieve.cc	Sieve for Prime Numbers
FastExpo.cc	Fast exponentiation

[Graph algorithms]
BFS.cc	BFS
DFS.cc	DFS
FastDijkstra.cc	Fast Dijkstra's algorithm
SCC.cc	Strongly connected components
BellmanFord.cc	Bellman Ford's algorithm
Kruskal.cc	Minimum Spanning Tree: Kruskal
FloydWarshall.cc	FloydWarshall's Algorithm

[Data structures]
SuffixArray.cc	Suffix array
BIT.cc	Binary Indexed Tree
UnionFind.cc	Union-find set(aka DSU)
LCA.cc	Lowest common ancestor
segmentTree.cc	Segment tree for range minima query
lazyProp.cc	Lazy Propogation for Range update and Query
ahoCurasick.cc	Aho Curasick Structure for string matching

[Miscellaneous]
template.h	C++ template
IO.cc	C++ input/output
LongestIncreasingSubsequence.cc	Longest increasing subsequence
KMP.cc	Knuth-Morris-Pratt
TopologicalSort.cc	Topological sort (C++)
LCS.cc	Longest common subsequence
MillerRabin.cc	Miller-Rabin Primality Test (C)

[Extra]
